111110000
000000000
000000000
000000000
000010000
000000000
000000000
000000000
000000000