111111111111111111
122222221122222221
122112221122211221
122222221122222221
122222222222222221
122112222222211221
122222211112222221
122222221122222221
111122200042221111
111122240402221111
122222221122222221
122222211112222221
122112222222211221
122222222222222221
122222221122222221
122112221122211221
122222321122222221
111111111111111111